6 11
|---------|
|.F.|..-..|
|..-|.@P..|
|.F....-..|
|.........|
|---------|
